       #         #         #     #   #   #   #     #         #               #             
 ## ## # # ##### # #  #### ### #   # # # # # # ###   # ### ### # ######## ## # ##### ### # 
 #       # #   #   #     #   # #   #   #   # #   #       #     # #   #       # #   #       
 # ##### # # # # # ### # ###   #####   ##### # # # ##### ####### ### # ####### ### ### ####
 # #   # # #     #   # # # # #     #     #   # # #     # #             #             #     
 # # # # # ######### #   # # # ### # ### # ### # ### # # ####  ### # ### ######### ####### 
 #   # # #   #     # # #     # #     #   #   # # #               # #   # # #     #         
 #####   ### # ### # # # # ##### # ### ##### ### # ###   # #####   # ### # # ### #  ###### 
           # # # # #   # #     # #           #   # #   # # #   # # # #   # #   # #   #     
# ##  ###### # # # # # # # ### #   ##### #####  ## # # # # # # # # # # ### ### # ### ######
       # #   # # # # # # #   #   # #   #     #   # # # # # # # # #       # #   #     #     
 # ###   #   # # # # # #   # ##### # # ##### ### # # # # # # ### ####### # # ######### ### 
 #   #   # # #   #   # # # #       # # #     #   #   # #   # #     #   # # #         #   # 
 ### ### # ####  ##### # # ######### # # ## ## # ########### # ##### # # # ######### ##  # 
   #   # # #     #     #       #     # # #     # #     #         #   # #     #     #     # 
 # ### # # # ## ###  # ######### ##### # # ### ### # # # ##### # # ### ##### ### ######### 
     #       #       #     #   # #   #   #   # #     # # #   #   #         #   #       # # 
 ### # # ##### ####### ### # # # # # ##### # # # ### # # # ######### ##### ### ##### #   # 
 # #   #     #   #     #   #     # #         #   #   #   #     #     #   #               # 
 # ####### # ### # ##### # # ##### ###### ######## # ######### # ##### # ### # ### ##### # 
 #     #   #   # #   #   # #     #           #     # #         #   # #       # #   # #   # 
 # ###   ##### # ### # # ####### ## ######## ####### # ###########   # #########   # # ### 
 #   #   #   #   # # # # #     # #     #   #     #   #     #       # # #     #     #     # 
 ##  ##### ####### # # ### # ### # ### # # # ### # ####### # # ##### # # ### # # # # ##### 
     #   #         # #     #   #     #   #   #   # #     # # # #   #   # #   #   # # #   # 
###### # #   ####### # # ##### #####   # ### # ### # #  ## # # ### # ### # # ### # # #   # 
       # # #     #   #   #           #   # # #   #   #   # # # #   #   #   #     # #   #   
 # ##  ### ##### # ### ### ######### ##### # ### ####### # ### # ##### ### ####### # # # # 
 # #   #   #     #     #         # #       #   #         # #   #     #   #       #   #     
 # ##### #   ##### ##### ##### # # ##### ##### ### ##### # #  ## # ##### ### # # ### # ####
 #   #   # #     #   #   #     #   #   # #     #   #   # # #   # #           # #     #     
 ### # ### ##### # # # ### ##### # ### # # ##  ## ## # # # #   ##### # ####### # # # ###   
 # #   #   #     #   #   # #   #   #   #   #   #     #     # # #   #       #   #   #   # # 
 # ##### # # # # # ### # # # # # ### ### # # ### ########### # # # ####### # ### # ### # # 
       # # #   # #       # #         #   # # #   #   #   #     # #       #   # # #       # 
## ### ### ### ########### ##### ##### ### ### ### # ### # # ### ####### # ###   ####### # 
     #   #   #         #       # #         #       #     # #     #       #     #     #   # 
 ### ### # # ##### ##### ##### ### ##### ### # ### #   # # ####### # # # ######### # # ### 
 # #   #   # #   #       #   #         # #   #     # #   #   #   # # #       #   # # # #   
 # ### ##### # # ######### #########   # # ### ### # # ####  # ### # # ##### # # ### #   # 
 # #     # #           # #     #   #     #     #             #     # # #     # #     # # # 
 # # ### # ##### # ### #   # ### # # # ### ### ### # # # ####### ### ### ##### # ## ## ### 
   #   #   #         # #   # #     # # #   #   #   #   #       #   #   # #     # #   # #   
## # # ### ##### ##### # ### # ### # ### ### ### # ########### ####### # ### # ### #   # # 
       # #     # #     #   #     #       #                   #     #   #     #     #   # # 
 ### ### ##### #   ######### ##### ## #### ########### ##### # ### # # ### # # # #######   
     #       #   #         #     #         # #       #     #     #   #   #   #   #   #   # 
 # ### # # ##### ######### ### # ####### ### # ##### ##### ############# ### # ###  ## # ##
 # #   #       #     #     #   #       # #   # # #         #       #     # #   #       #   
 # # ##### ### ### ### ##### ##### ###     # # # # #   ##### ### # # #####   # ## ######## 
 # # #   #   #   #     #       #     # # # # #   # #       # # # # #     # # #           # 
   # # # ##### ### # ######### ### # # # ### ### # # # # # # # # ####### # # ## # ###### # 
 # # #       # #   # #       # #   # # #   #   # # #     #     #           #      B  #     
 # ### ##### # # ### # # ### # #   # # ### # # # # ## #  ####### #  ######### ###### ##### 
 # #   #   # #   #   # #       # #   #   # # #     #         #   #         #       #     # 
##   ### # # # ### ### ######### ### ### # #######   ####### #  ## #####   # ##### ##### # 
   #     #   #   # # #     #   #   # #   #       #   #     #       #     # # #   #   #   # 
 # # ### ### ##### #   ### # ### # # # ###### ## # # ### # # ####### ##### # # # ### # ### 
   # #   #   #   # #     # #     #   #     #     # #   # #   #       #   #   # #     #   # 
 ### # # ##### # # ####### ######### # # # ##### # # # # # ### #  ###### ##### ######### ##
     #         # #         #         #   #     #   # #   # #   #             #   #     #   
 ## ## ## ###### ######## ## #### ############ ### # ##  # # ##### ######### ### ### # ### 
 #   #           #     #   #       #         # #     #   #   #   #   #         #     #   # 
 #   ### ### # # # ### # # # ##### # ### ### # ####### ####### # ###    ###### ######### # 
   #   # #   # #   # #   #   #   #   # #   # #       #     #   # #   #   #   #   #     #   
###### # #  ## ##### ### # ### # # ### ### ### # ### ##### # ### #  #### # # ### # # ##### 
     # # #   #       #     #   #     #   #   #   #       #   #       #   #     # # # #     
 ## ## ##### ####### # ###   ####A## # # ### ##### ##  # # ### ### # # ### ### # # # # ## #
       #             #   #   #     #   #   #       #   # #   # #   #     #   #   # #   #   
  ###### ###### ## ####  ##### ########### ### ### ##  # ### # # ########### ## ## ##### # 
   #   #         #   #   #     #             # #       #   # # # #     #   # #   # #     # 
##   # # # ### # ##### ### # ### ######### ### # #### #### # # # ### # # # # # # # # ##### 
 #   # # #   # #         #   #   #       # #   # # #       # # #   # # # # #   #     #     
 # # # ### # ########### # ### ### ####### # ### # # ####### # ### # ### # ########### ####
 #   # #   #         #     #   #           # #     # #     # #   #       #         # #     
 # #     ######## ## ####### ### ##### ##### ##### # #   # # ### # ### ########### # # # # 
 # #   #     #     #           # #         #       # #     # # # # #   #       #   # # # # 
 # # # ##### # # # ####### ### # # # # # # ### ##  # ##### # # # #   ### # # ### ###   ### 
 #           # # # #     #   # # # #     #     #   #     # # # # # #   # # # #   #   #   # 
   # ##### ### # # # # ##### # # # ### ### ## ## # # ### # # #   # ### # # ### ####  # # # 
   # #   #     # # # # #       # # # # #         #       # #   # # #   # #               # 
 ### # # ### # # # # # # ##### ### #   # ##### ### ### # # ### # ### ### ###   # #### ## # 
 #   # #     #   #   # # #   #     # # # #       #   # # # #   #     #       # # #     # # 
 # # # #### ###### ##### # # # ##### # # ####  # ### # # # # ##### ### ## ## # # # ### # # 
 # #   #                   # #   #     #       #   #     #   #   # #         # #   # #   # 
 ### # ############# ####### ### # ############### # ####### # # # ##    #   # ### # ##### 
   # #               #   #   # # #     #     #   # #       # # # #       #   #   #         
## # # ### # # # ##### #   # # # ####### ### # # # # # ### ### # # # ####### ### #### #### 
   # #   # # # #       # # #   #       # # # # # # # #   #     #   #       #     # #     # 
 ### ### # # # ####### # # ### ####### #   # #   # ### # ########  # ####  # ##### # ### # 
     #   #   #             #         #     #   #       #             #       #         #   
