       #     #           #             #       #   
 ##### # ##### ####### ### #######   # # #  ## # # 
     # #     #       #       #   # # # # #   #   # 
 ### # # ### ####### ######### # ### ### ### ######
 #     # #     #   # #     #   #     #   # #       
   ### ### ##    # # # ###   ####### # ### ##### # 
 # # #     #   # #   #   # # #   # # #     #   # # 
## # # ## ###### ##### # ### # # # # ### ### # ### 
   #   #         #     #   #   # # #     #   #     
 ####### ################# ##### # # ### # ####### 
 #       # #                 # # #   #   # #   #   
 # ### ### # # #####  ######   # ##### ### # # # ##
   #         #     #     # # # #   #   #   # # # # 
 # #### ######   # # # # #   # ###   ### ### # # # 
             #   # #   #   # #     #   #     # #   
 ####### ### ##### # ##### # # # # # ##### # # ### 
 #         #       # #     #   # #   #   # # #     
 # ## #### ###### ## ########### ##### # # ##### ##
 # #     # #   #               # # #   #   #       
   # # ### # # ######## # ## # # # # ##### # # ### 
 #   # #     # #             #   # #       # # #   
 ##### # # # # # #   ########### # ## ## ### # ####
 # #   # # #     # #         #     #     #A  #     
 # # ### # #  #### # # ##### # ##### ### # ####### 
 # # # #   #   #   # #     #   #     #   #   #     
B  # # # ### ### ### # ### ##### # #########   # ##
 # #   #     #   # # #   #     # # #   #     #     
 # # # # ##### ### # ####### #   ### # # ######### 
 #   #   #   #     #       # # # #   #   #       # 
 # # ### #  #### # # ##### # ### # ####### ##### # 
       # #       # #       #   # # #     # #   #   
## #   # # # ### # #  #### # # # # ### ### #   ##  
 # #   # # # #   #         # # #     # #   # # #   
 # ### # ### # ### ####### ### # ###   # ### # # ##
   #   #   # # #   #   #     # #       #   # #   # 
 ### ##### # # ### # # ##### # #### ## ### # ### # 
           # # #     # #   #     #   # #   #   #   
#### # ##### # # ##### # # ####### # # # # ### #   
   # # #     #   #   #   #         #   # #   # # # 
 # # # # ### ##### # ################# # # # # # # 
 #   # # #   #               #   #     # #       # 
#### # ### # ############# # # # # ##### ###### ## 
   # #     # #           # #   # #   #       #   # 
 # # # ##### # ######### ### # # ### ##### # # # # 
 # # #       #     #       # #     #   #     #     
 # ### ########### # #####   # ### ### # ##### # # 
 #     #           #     # # #     #   #   #   #   
 ####### ### ####### ### # ### # ####### # # # # ##
 #         # #     #   #       #     #   # # # # # 
 ###########   # ##### ##### ### # # ##### # ### # 
             # #             #     #       #       
