           #         # #       
## #### #### # ## ##   #  ## ##
   #               # #     #   
 ### ### ### # ### # ### # # # 
     #       # #   #   # #   # 
###### ### ### # ####  # # # # 
       #       # #     # # #   
 # #############   ##### # ### 
 # #           #   #       #   
 ### ####### # # # ##### ###  #
 #   #     # # #       # # #   
 # ### # # # # ####### #   ### 
       # # # # #   #     #   # 
## ##### #   # # # # ##### ### 
   #     #   #           #   # 
 # ### ##### ######### # # # # 
 #                     # # # # 
 ###B ### #### ######### ### # 
   #   #   #       #     #   # 
#  ### # # # ##### # ##### ### 
   #         #   # #   #   #   
 ### # ####### # # # # # # # ##
 #       #   # # # #   # # # # 
 ####### # # ### # # ### ### # 
   #   #   #   # #   #       # 
## # # ####### # ##### ##### # 
 #   # #   #   # #     #    A# 
 # ### # # # ### # ##### ### # 
         # # # #   #       #   
 # ##### # # # # ### ##### # # 
 #           #             #   
