 #                 # 
 # ############  # # 
 #           #   # # 
 ####### # # # ### # 
       #   # # #   # 
# ## # ### # #   ### 
     #   # # # # #   
 ######### # # # # ##
 #   #       # # #   
 # # # ####### # ### 
   #       #   #     
 ######## ## ####### 
 #         #   #     
## #  #### ### ######
   #           #     
 ############# ##### 
           #A      # 
 ######### # ### ### 
   #  B    #     #   
## ### #  ######## ##
       #             
