     #         #         #     
 #   ### # ### # ##### ### # # 
 # #   # #   # #   #   #   # # 
 # ### # ### # ##### ### ### # 
 # # #  B  # # #     #   #     
## # #  #### # # ### # ### ### 
   #         #   #   # #     # 
 # # ##### ### #######   ### # 
 # #   #   #   #     # # #   # 
 ### # # ### # # ### # # # ####
     #       #   #   #   #     
 ### # # ######### ### ### ### 
   #   # # #           #   #   
## # # # # # ###  ###### # #  #
   # # #   #   #         # #   
   # # # # ### ########### ### 
 #   # #   # # #         # #   
 ##### ### # # # # ##### # # # 
 #   # # #   # # #   #   #   # 
   # # # ##  # # # # # ####### 
 # # #   #   #     #       #   
 # # ##### ######### ##### ####
 # #       #             #     
 # ####### # # #### ## ####### 
 #       #   #       # #       
   # ### # # #  #### # # ##### 
       #   # #     #   # #   # 
 ##### ##  # ##### ### # # # # 
     # #   # A #   # #   # # # 
 #####   ####### # # ##### ### 
 #     #         #             
