     #     #         
#### # ### # # ##### 
   # #   #   # #     
 # # ### ##### ##### 
 # #   #   # # #   # 
 # # # ### # # # # ##
 #A  #   # # #   #   
 # ####### # ####### 
 # #   #   #     #   
 ### # # ### ### # ##
   # #     # #   #   
 # # ##### # # ##### 
 #   #   #   # #   # 
 ##### # ##### ### # 
 # #   # #     #   # 
 # ##### # ##### # # 
     #   #       # # 
###### ### ######### 
       #   #       # 
 ########### ##### #B
             #       
