 #       #   #       #               #                     #           
 # # ##### # # ### # ##### ### ##### # ##### ############# ##### ######
 # # #     #   # # #     # #   #   # # #   # #     #             #     
 # # # ######### # ##### ### ### # # ### # # # ### # ########### # ### 
 # # #   #   #   #   # #     #   # #     # # # # # #     #     # #   # 
 # # ### # ### # ### # ####### ### ####### # # # # ##### # ### ### ### 
 # #     # #   #   # #           #       #   # # #     # # # #     #   
 # ####### # ### ### # ######### # ### ##### # # ##### ### # ####### ##
   #     #   #   #   # #       # # #   #     #       # #   #   #   #   
 ### ### ##### ### ### # ##### ### # ### ########### # # ##### # # ### 
 #   # # #     #   #   #   # #   # #   # #   #       #   #     # #   # 
 ### # # # ### # ######### # ### # ##### # ### ########### ### # ### # 
     # # # #   #         # #   # # #     #   #   #     #   #   #   #   
###### # # ### ####### ### # # # # # ####### ### ### # # # # ##### ####
 #     # #   #       #     # # # #           # #   # #   # #     # #   
 # # ### ### ####### ######### # ########### # ### ### ### ##### # # # 
   #   #   #       #       #   #   #     #       #   # # #     # # # # 
###### ### ####### ####### # # ### # ### ##### ##### # # ##### # # # # 
     #   # #       #   #   # #   #   # #     # #     #   #   # # #   # 
 ### ### # # ####### # # ### ### ##### ##### ### ####### ### # ####### 
   #   # # #   #     # # #   #   #         #   #   # #   #   #     #   
## ### # # ### ####### # # ### ### ##### ##### ### # # ### ##### # # # 
   #     # #   #   #   #   #   #       # #     # # # # #   #   # # # # 
 ### ##### # ### # # ####### ##### ### # # ### # # # # # ### # # ### # 
 #   #   #   #   # # #     #     # # # # # #     # # # # #   #   #   # 
 # ### # ####### # # # # ####### # # # # # ####### # # # # ##### # ####
 #   # #         #   # # #     # #   # # #     #   # #   # #     #     
 ##### # ########### # # # ### # ### # # ##### # ### ### # # ######### 
 #     #   #         # # #   # # # # # #   #   #   # #   # # #     #   
 # ####### ########### # ### # # # # # ### # ##### # # ### ### ### # ##
 #   #   #     #   #   #   # #   #   #   # #       #     #       # #   
 ### # # ##### # # # ##### # ########### # ######### ######### ### ### 
 #   # #   # #   #     #   #         #   #         # #       # #     # 
 # ##### # # ########### # ######### # ### ######### # ##### ### # ### 
   #     #   #     #     # # #     # #   # #         # #   #   # # #   
 ### ####### # ### # ##### # # ### # # # ### ######### # # ### # ### ##
     #     #   #   #   #   # # # #   # #   # #       # # #   # #   #   
###### ### ### ####### # ### # # ##### ### # # ### ### # ### # ### ### 
 #   #   # #   #       #     # #     #   # # #   # #   #   #   #     # 
 # # ### # # ### ##### ####### # # # ##### # ### # # ####### ### ### # 
   #     #   # #   #   #      A# # #       #   # # #       #   # #   # 
 ############# ### # ### ######### ####### ### # # ####### ### # ##### 
     #   #   #   # #   #   #       #     #   #   #     #   #     #     
#### # ### # # # # ### ### # # ##### ####### ######### # ##### ### ### 
   # #     #   # #   #   # # # #       #   # #         # #   # #   #   
 # # ####### ### ### ### # # # ##### # # # # # ######### # # # # ######
 # #       #   #   # #   # # #     # #   #   # #     #   # # # #   #   
 # ####### ##### # # # ### ####### # ######### # ### # # # # ### # # # 
 #     # # #     # # # # # #   #   #     #     #   # # # # #   # #   # 
 ##### # # # ####### # # # # # # ######### ####### # # ### ### # ##### 
     # # #   #     # #   #   # #         #   #     #   #   #   #     # 
## ### # ### # ### # ######### # ####### ### # # ####### ##### ### ### 
 # #   #   # # #   #         # # #     # #   # # #     #     #   # #   
 # # ##### # # # ### ### ##### # ### # # # ### ### ### # ### ### ### # 
 # # #   #   # #   # #   #     #     # #   #   #   #   #   # #       # 
 # # # # # ### ### ### # # ####### ######### ### ### ####### ######### 
 # #   # # # # #       # #   #     #     #   #   # # #       #   # #   
 # ##### # # # ####### ##### ####### ### # ### ### # # ####### # # # ##
     #   # # #   #   # #   #       # #     #   #     # #       # # #   
 ##### ### # ### # ### # # ####### # ####### ### ##### # ####### # ### 
 #     #   #   # #     # #           #     #   #     # #   #   # #   # 
 ####### ### # # ####### ########### # ### ### ##### # ### ### # # ### 
       #     # #   #   #     #   #   # # #     #     #         # # #   
###### ####### ### # # ### ### # ##### # ####### ############### # # ##
     #       #   #   # #   #   # #     #       # #     #         #   # 
 # ######### # ##### # # ### ### # ##### ##### # # ### # ######### ### 
 # #     #   # #   # #   #   # # #     # #   # #  B#   #     #   # #   
## # # ### ##### # ####### ### # ##### # # # # ##### ####### # ### ### 
   # #     #     #   #   # #   #       # # # # #   # #   #   # #   #   
 ### ######### ##### # # # # # ######### # # # # # # # # # ### # ### # 
               #       #   # #             # #   #     #   #         # 
