 #         #         # #   #           #           
 # ##### # # ### ### # # # # ######### # ### ##### 
 # #   # #   #   #   #   # #   #       # #   #     
 # ### # # # # ### ####### ### # # ##### # # ######
 # #   #   # # #             #           # # #   # 
 # # # # # # # ########## ## ### # ### ### # #   # 
 #   #     # #       #     #     #   #     # # #   
 ##### #   # # #####   ### # ####### # ### ### ####
   #   #     #   # #   # # #         #   # #   #   
 ### ####### # # # ##### # ######### ### ### ### # 
     #         #     #   #     # #     #  A# #   # 
  #### ####### ### # ### # ### # # ### ### #     ##
   #   #       #   #   # # #     # #     #   # #   
## # ### ### # # # ### # # # # ### # # ####### ### 
 #     #   #   #         #     #   # #       #     
 # ##### # ##### # ####### #####  ## # # # # ### # 
   #   # #         #   #   #   #   #   # # #   # # 
 ### # # # # ### # # ### # # # ### ### # # ### ### 
 #   # # #     # # # #           #   #   # # #   # 
 # # # # ### # # # # #  ##   #   ### ##### # ### # 
 # # # #     # # #   #   # # # #   # #     #   # # 
 # # # ### ### # ### ### ### # ### # # #   # # # # 
 # # #   # #   #       #         # # # #   # #   # 
 #   ### ### ##### ### ####### ### #   #####   # # 
 # #   # #       #   #       # #   #   #   # # #   
 ##### # # ### # ### ###  ## #   # ##### # # # ### 
           #   #   #       # # #     #   # # #   # 
 # ## ###### ### # # ##### # # # # #   # ### ### # 
 #     # #     #         # #     # #           # # 
 ##### # # # # # # ##  # # ##### # ##### ####### # 
       #   #   # # #     #   #   #   #       #   # 
## ##### ### ### # ##### ### #  #### # ##### # # # 
         #   #   #     #   #       # # #     #   # 
 ### ##### ##### ##### #####  #### # # ### ### ### 
 #         #         #         #   # #   # #   #   
 # ### ##### # # ### ### # ##### ### ### # # # # ##
 #       #   #       #   # #   # #     # # #   #   
 # # #  ## # ####### # ### # # # # # ### # ### # # 
 #   #     #   #     # #   # #   # # #       #   # 
## # ### ### # # ##### ### # ## ## ### ### # #   # 
   #   #     #                   #     #   # #     
 ###   #   ######## # #########  ####### # ########
 #   # #   #                     #     # #       # 
   ### ##### # #######   ######### # ### ##### # # 
   # #       #       #   #         # #       # #   
 ### ## ###### ##### # ###### ## # # # #### ## ### 
   #     #       #     #       #         #       # 
## # # # # # ##### ### # ##### # ######### ##  # # 
   # # #   #           #   #   # #   #   # #   #   
 ##### # ### ######  ##### #   ### # # # # # # # ##
       #     #             #     B #   #   # #     
