 #           #         #     #             #   #       #           #   
 # ##### # # # # ### ### # # ### ######### # # #   # ### ####### # # # 
 # #   #     # #     #   # #     #       # # # # #       #       # # # 
 # ### ### # # # ### # ### # ##### ### ### # ### ######### ## ## # ### 
 #   #   # # # #   # #   # # #   # #   #   #   # #   #     #     #     
 ###   ### # ##### ##### # ###   ### ### ##### # #   # ### ### ###   # 
     #   # #     #   #   # #   # #             # # # # #       #   # # 
 ####### # ##### ### # ### # ### # ### ### ### # # # # # ### # # ### # 
 #       #   # #       #   #   # #         #   # # # #     # # # #   # 
 ##  ####### # ### # ### ##### # ####### ####### # # # ##### #   # ####
     #       #   #     #       # #   #   #       # #         #   # #   
###### ######### ##### ######### # # # ### ##### # # ### ##### ### # # 
     #   #           #     #   #   #   #   #   #   #     #   #       # 
 ### ### ##### ##### ##### # # ####### # ### # ####### ### # # # # # # 
 #   #   #   # #   #   # #   #           #   #       # #   # # #   #   
 # #   ### # # #   ### # ######### # # ###   ####### # # ##### ###   ##
 # #       # #       # # #           #   #     #   #   #       #   #   
 # ###   ###   ##### # # # ######### ##### ### # # #  ###### ########  
 #     # # # #   #   #   #   #   #         # #   #     #   #   #       
 ##### # # # ##### ######### # # # ### # # # ##### ##  # # ### # ##### 
 #     #   #     #       #   # # # #   # #   #     #   # # #     #   # 
   ####### # # # # ##### # ### # # # # # ### ### # # ###   ####### ### 
 #   #   #B#   #   #     #     #   # # #   # #   # #   # #   #         
 ### # # # #   # # # ######  ####### ##### #   ### ### # ### ####### # 
     # #   # #   # #               #       # # #   # #     # #   #   # 
#### # ### # ##### # #   ######### # # ## ## # #  ## # ### # # # # # # 
       #   #   # # # # #   #     # #       # # #     #     #   #   # # 
 ### #   # ### # # # # # ### # # # ####### # # # # ### ############# # 
   # # # #     # #   #   #   # # #   #     #     #   #             # # 
## ### # ####  # # ####### ###   # # # ##### ##### # ##### ## ###### # 
   #   # #     #   #       #   # # #   #   # #     # #     #         # 
  ## ### # ##### ### ##### ### # ### ##### # # ##### ####### ###### ## 
         #   # #   #   #       #   #         # # #   #     # #       # 
 ######  ### # ### # # ### ##### # ## ## ##### # # ### ### # # ## ## # 
     #       #       #     #   #       #           #   #   # # #   #   
#### # ##### # ##### ### # # # ### ### ########  ##### # ### # ### ####
     # #     # #       # # # #   #   #   #   #   #     # #   #   #     
 ### # # ####### # # # # # # ### ####### # # # ### # ### # ##### ### # 
 #   # #   #     #   # # # # # #         # # # #   # #     #   #   # # 
 # ### ### # ####### ### # # # ########### # # ##### ##### #   # # #   
   #     # #       # #     # #     #       #         #   # # #   # # # 
 ##### ### ##### ###   ##### # ###   ##### ######### # # ### ### # # # 
   #   #     #   #   #   #   #   #   #     #         # # #   # # #     
## # #   # # # ### # ### # ##### ##### ##### ######### # # # #   ##### 
   # # # # # #     # #   #     #   # # #   #     #   # #   #         # 
 ### # # # # # # ### # ####### # # # # # # ###     # # # ########### ##
     #   #   # #     # #     #       # # #     # # #   #           #   
 ### # # # ### # # ### # ### # ### ### # ### ### # ## ## ##### ####### 
       # # #     #   # #   # #   # #   #   #     # #         #     #   
 # ###   ### ####### # # # # ### ### ### ######### # # ### # # # ### ##
     #   #   #       # # #       #   #   #     #   # #   #   # #   # # 
#### # # # ### ####  # ### ### ### ### ### ### # ### ### # # # ### # # 
       #     #   #   # #   #   #   #   #   # # #     # #   #   # #   # 
 ########## #### # ### # ### ### ### ### ###   ####### ##### ### ##### 
         #       # # #   #   # #     #   #   #     #       #       #   
## ####### ## # ## # # ### ### # # # # ### # ### # # # ########### # # 
   #       #     # # # #   #   # #   # #   # #       # #         # # # 
 ### # ### # ### # # # # #####   # # # # # # # #######   # ### # # # # 
 #   #     #   # # # # #     #   # #   # #   #       # # #   # # # #   
 # # # ##### ### # # # ##### ##### ##### # ###   ### # # # # # ### # # 
             #   # # #   # #         #   #     #   #   #   # # #   # # 
 ###### ###### ### # ### # ##### ### # ###   ##### # ### ##### # ##### 
 #           #         #A  #   #     #   # #     #     # #     #     # 
 # #######   # ########### # # #########   ##### ##### # # ### #   # # 
 #   #   # # #   #         # #     #     # #   #       # # #   #   # # 
 # ### # # # ### # ############# ### # # # ### ##### ###   #  ###### # 
 # #     # # #   #         #   #     # #   #   # #   #   # #       # # 
 # # ### # # # ######## ## # # # ##### # ### # #   ### ### #####  ## # 
 # #     # # #       #   # # #   #     #     #   #   # # #     #   #   
 ### # ### # ##  ### # # # # ### # ############# ### # # ##### # # ##  
     #     #       #   #     #     #               #         #   #     
