             #     #     #     
######## ### ### # # ### # ### 
     #   # #     # # # #   # # 
 ### # ### ### ##### # ##### # 
 # # #   #     #   # #       # 
 # # # # # ##### # # # ####### 
 #   # # # # #   #   # #       
 # ##### # #A# ####### # ######
 #       # # # #   #   # #   # 
 ######### # # ### # ### # #B# 
         # # #     #     # #   
######## # # ####### ##### ### 
     #   #   #       #       # 
 ### # ##### # ############# # 
   #   #   # #   #           # 
## ##### # ##### # ########### 
   #   # # #     # #     # #   
 ### # # # # ##### ### # # # ##
   # # # #   #     #   #   # # 
 # # # # ####### ### ####### # 
 #   # # #       #     #   # # 
 ##### # ##### ### ### # # # # 
 # #   # #     #     # # # #   
 # # ### # ######### # # # ### 
 # # #   #         # #   #   # 
 # # # ####### ### # ####### # 
 # # #       # # # #   #   #   
 # # ####### # # # ### ### ####
   #       # #   # #   #     # 
## ##### ### ##### # ### ### # 
       #           #     #     
